"filename", "language", "Java", "Java Properties", "comment", "blank", "total"
"/Users/nickgendron/Desktop/CSC-3380-Rainbow-Team/backend/src/main/java/com/springbackend/app/rest/Attractions/Attractions.java", "Java", 126, 0, 12, 39, 177
"/Users/nickgendron/Desktop/CSC-3380-Rainbow-Team/backend/src/main/java/com/springbackend/app/rest/Attractions/AttractionsController.java", "Java", 130, 0, 37, 47, 214
"/Users/nickgendron/Desktop/CSC-3380-Rainbow-Team/backend/src/main/java/com/springbackend/app/rest/Attractions/AttractionsRepo.java", "Java", 16, 0, 0, 7, 23
"/Users/nickgendron/Desktop/CSC-3380-Rainbow-Team/backend/src/main/java/com/springbackend/app/rest/BudgetBuilder/BudgetBuilder.java", "Java", 34, 0, 0, 11, 45
"/Users/nickgendron/Desktop/CSC-3380-Rainbow-Team/backend/src/main/java/com/springbackend/app/rest/Flights/FlightObjects/Flights.java", "Java", 29, 0, 1, 13, 43
"/Users/nickgendron/Desktop/CSC-3380-Rainbow-Team/backend/src/main/java/com/springbackend/app/rest/Flights/FlightObjects/FlightsConfig.java", "Java", 27, 0, 1, 10, 38
"/Users/nickgendron/Desktop/CSC-3380-Rainbow-Team/backend/src/main/java/com/springbackend/app/rest/Flights/FlightsController.java", "Java", 288, 0, 63, 103, 454
"/Users/nickgendron/Desktop/CSC-3380-Rainbow-Team/backend/src/main/java/com/springbackend/app/rest/Flights/FlightsRepo.java", "Java", 34, 0, 0, 18, 52
"/Users/nickgendron/Desktop/CSC-3380-Rainbow-Team/backend/src/main/java/com/springbackend/app/rest/Flights/ItineraryObjects/Itineraries.java", "Java", 59, 0, 3, 19, 81
"/Users/nickgendron/Desktop/CSC-3380-Rainbow-Team/backend/src/main/java/com/springbackend/app/rest/Flights/ItineraryObjects/ItinerariesRepo.java", "Java", 4, 0, 0, 3, 7
"/Users/nickgendron/Desktop/CSC-3380-Rainbow-Team/backend/src/main/java/com/springbackend/app/rest/Flights/SegmentObject/Segments.java", "Java", 49, 0, 0, 8, 57
"/Users/nickgendron/Desktop/CSC-3380-Rainbow-Team/backend/src/main/java/com/springbackend/app/rest/Flights/SegmentObject/SegmentsRepo.java", "Java", 4, 0, 0, 3, 7
"/Users/nickgendron/Desktop/CSC-3380-Rainbow-Team/backend/src/main/java/com/springbackend/app/rest/Hotels/HotelController.java", "Java", 139, 0, 49, 73, 261
"/Users/nickgendron/Desktop/CSC-3380-Rainbow-Team/backend/src/main/java/com/springbackend/app/rest/Hotels/Hotels.java", "Java", 152, 0, 15, 35, 202
"/Users/nickgendron/Desktop/CSC-3380-Rainbow-Team/backend/src/main/java/com/springbackend/app/rest/Hotels/HotelsRepo.java", "Java", 10, 0, 0, 6, 16
"/Users/nickgendron/Desktop/CSC-3380-Rainbow-Team/backend/src/main/java/com/springbackend/app/rest/RestApplication.java", "Java", 15, 0, 1, 7, 23
"/Users/nickgendron/Desktop/CSC-3380-Rainbow-Team/backend/src/main/java/com/springbackend/app/rest/Restaurants/Restaurants.java", "Java", 108, 0, 0, 29, 137
"/Users/nickgendron/Desktop/CSC-3380-Rainbow-Team/backend/src/main/java/com/springbackend/app/rest/Restaurants/RestaurantsController.java", "Java", 115, 0, 36, 41, 192
"/Users/nickgendron/Desktop/CSC-3380-Rainbow-Team/backend/src/main/java/com/springbackend/app/rest/Restaurants/RestaurantsRepo.java", "Java", 4, 0, 0, 3, 7
"/Users/nickgendron/Desktop/CSC-3380-Rainbow-Team/backend/src/main/java/com/springbackend/app/rest/Security/ApplicationSecurity.java", "Java", 25, 0, 12, 10, 47
"/Users/nickgendron/Desktop/CSC-3380-Rainbow-Team/backend/src/main/java/com/springbackend/app/rest/Security/LoginController.java", "Java", 21, 0, 0, 6, 27
"/Users/nickgendron/Desktop/CSC-3380-Rainbow-Team/backend/src/main/java/com/springbackend/app/rest/Security/SecurityConfig.java", "Java", 0, 0, 23, 2, 25
"/Users/nickgendron/Desktop/CSC-3380-Rainbow-Team/backend/src/main/java/com/springbackend/app/rest/User/User.java", "Java", 46, 0, 7, 17, 70
"/Users/nickgendron/Desktop/CSC-3380-Rainbow-Team/backend/src/main/java/com/springbackend/app/rest/User/UserController.java", "Java", 37, 0, 21, 14, 72
"/Users/nickgendron/Desktop/CSC-3380-Rainbow-Team/backend/src/main/java/com/springbackend/app/rest/User/UserRepo.java", "Java", 10, 0, 0, 6, 16
"/Users/nickgendron/Desktop/CSC-3380-Rainbow-Team/backend/src/main/java/com/springbackend/app/rest/User/UserRepoOAuth.java", "Java", 7, 0, 0, 3, 10
"/Users/nickgendron/Desktop/CSC-3380-Rainbow-Team/backend/src/main/java/com/springbackend/app/rest/Vacation/Vacation.java", "Java", 67, 0, 11, 20, 98
"/Users/nickgendron/Desktop/CSC-3380-Rainbow-Team/backend/src/main/java/com/springbackend/app/rest/Vacation/VacationController.java", "Java", 152, 0, 7, 42, 201
"/Users/nickgendron/Desktop/CSC-3380-Rainbow-Team/backend/src/main/java/com/springbackend/app/rest/Vacation/VacationRepo.java", "Java", 13, 0, 0, 7, 20
"/Users/nickgendron/Desktop/CSC-3380-Rainbow-Team/backend/src/main/java/com/springbackend/app/rest/VacationBuilder/VacationBuilder.java", "Java", 13, 0, 10, 8, 31
"/Users/nickgendron/Desktop/CSC-3380-Rainbow-Team/backend/src/main/resources/application-dev.properties", "Java Properties", 0, 0, 0, 1, 1
"/Users/nickgendron/Desktop/CSC-3380-Rainbow-Team/backend/src/main/resources/application.properties", "Java Properties", 0, 19, 10, 10, 39
"/Users/nickgendron/Desktop/CSC-3380-Rainbow-Team/backend/src/test/java/com/springbackend/app/rest/RestApplicationTests.java", "Java", 9, 0, 0, 5, 14
"Total", "-", 1743, 19, 319, 626, 2707